111111111111
1000000000E1
100C000C0001
10000P000001
111111111111