1111111111111111111111111111111111
100000000000001C10000C000000111001
1110010100100000001001000001110101
1110010010101010001001000000010111
10000000C00C0000P0000C00000E0000C1
1111111111111111111111111111111111